1111111111111
1000000000001
1000000000011
10C000000001
1000000000011
10000E0000001
10P0000000001
1000000000001
1111111111111
