
1111111111111
1000000000001
10E0010000001
1000010000001
10P00C0000001
1000000000001
1111111111111
