11111111
10000001
10000001
10000001
10000001
10000001
10000001
10P0P001
10000001
1000E001
10000C01
11111111
