1111111 111111
1000000 000001
10E0010 000001
1000010 000001
1111111 111101
1000010 000001
10P00C0 000001
1000000 000001
1111111 111111
