1111111
1000101
1P01001
1000000
1E00001
1000001
10000C1
1111111
