111111111111
100000000001
100100000001
1000000E0001
100C00000001
10P000000001
100000000001
111111111111
