11111111111111111
100N000N000000001
10000000N0N000001
100N0000000000001
10011111000000001
100N0100NNN000001
10000100000000001
10P001000C0N00001
100N0000000000NE1
11111111111111111
