1111111111111
1P010000000C1
1100011111001
11C011E0C0001
1111111111111
