11111111111111111
10000000000000001
10000000000000001
10000000000000001
10011111000000001
10000100000000001
10000100000000001
10P001000C0N00001
100000000000000E1
11111111111111111
