11111111111
10000000001
10000000001
100C0000001
10100000001
11P10000E01
10100000001
11111111111
