1111111111111
10000000001N1
100C000000001
100E000000011
1P000000000C1
1111111111111
