1111111111111
1CCCCCCCCCCC1
1CCCCCCCCCCC1
1CCCCCCCCCCC1
1CCCCC0CC0CC1
1CCCC0N00N0C1
1CCCCC0CC0CC1
1CCCCECCCCCC1
1CCCCCCCCCPC1
1111111111111
