11111111111
10000000001
10000000001
100C0000001
10000000001
10P00000E01
10000000001
11111111111
