111111111111111
101111111111111
100000000101011
1111111111111111
